11111111111111111111111111
10010000000000000000000VC1
1000000000000000000CC00001
1000000E00000V00000CC00001
1000000000000000000CC00001
100000V00000C0V0000CC00001
10000111110000000000000001
1P001110000000C00000000001
11111111111111111111111111