11111111111111111111111111
100100000000000000000000C1
1000000000000000000CC00011
1000000E00000000000CC00001
1000000000000000000CC00001
100000000000C000000CC00001
10000111110000000000000001
1P001110000000C00000000001
11111111111111111111111111